AFG	AFG
	ALA
ALB	ALB
ALG	DZA
ASA	ASM
AND	AND
ANG	AGO
AIA	AIA
	ATA
ATG	ATG
ARG	ARG
ARM	ARM
ARU	ABW
AUS	AUS
AUT	AUT
AZE	AZE
BAH	BHS
BHR	BHR
BAN	BGD
BRB	BRB
BLR	BLR
BEL	BEL
BLZ	BLZ
BEN	BEN
BER	BMU
BHU	BTN
BOL	BOL
	BES
BIH	BIH
BOT	BWA
	BVT
BRA	BRA
	IOT
VGB	VGB
BRU	BRN
BUL	BGR
BFA	BFA
BDI	BDI
CAM	KHM
CMR	CMR
CAN	CAN
CPV	CPV
CAY	CYM
CTA	CAF
CHA	TCD
CHI	CHL
CHN	CHN
	CXR
	CCK
COL	COL
COM	COM
COD	COD
CGO	COG
COK	COK
CRC	CRI
CIV	CIV
CRO	HRV
CUB	CUB
CUW	CUW
CYP	CYP
CZE	CZE
DEN	DNK
DJI	DJI
DMA	DMA
DOM	DOM
ECU	ECU
EGY	EGY
SLV	SLV
ENG	GBR
EQG	GNQ
ERI	ERI
EST	EST
ETH	ETH
	FLK
FRO	FRO
FIJ	FJI
FIN	FIN
FRA	FRA
	GUF
TAH	PYF
	ATF
GAB	GAB
GAM	GMB
GEO	GEO
GER	DEU
GHA	GHA
	GIB
GRE	GRC
	GRL
GRN	GRD
	GLP
GUM	GUM
GUA	GTM
	GGY
GUI	GIN
GNB	GNB
GUY	GUY
HAI	HTI
	HMD
HON	HND
HKG	HKG
HUN	HUN
ISL	ISL
IND	IND
IDN	IDN
IRN	IRN
IRQ	IRQ
IRL	IRL
	IMN
ISR	ISR
ITA	ITA
JAM	JAM
JPN	JPN
	JEY
JOR	JOR
KAZ	KAZ
KEN	KEN
	KIR
PRK	PRK
KOR	KOR
KUW	KWT
KGZ	KGZ
LAO	LAO
LVA	LVA
LIB	LBN
LES	LSO
LBR	LBR
LBY	LBY
LIE	LIE
LTU	LTU
LUX	LUX
MAC	MAC
MKD	MKD
MAD	MDG
MWI	MWI
MAS	MYS
MDV	MDV
MLI	MLI
MLT	MLT
	MHL
	MTQ
MTN	MRT
MRI	MUS
	MYT
MEX	MEX
	FSM
MDA	MDA
	MCO
MNG	MNG
MNE	MNE
MSR	MSR
MAR	MAR
MOZ	MOZ
MYA	MMR
NAM	NAM
	NRU
NEP	NPL
NED	NLD
NCL	NCL
NZL	NZL
NCA	NIC
NIG	NER
NGA	NGA
	NIU
	NFK
NIR	[6]
	MNP
NOR	NOR
OMA	OMN
PAK	PAK
	PLW
PLE	PSE
PAN	PAN
PNG	PNG
PAR	PRY
PER	PER
PHI	PHL
	PCN
POL	POL
POR	PRT
PUR	PRI
QAT	QAT
	REU
ROU	ROU
RUS	RUS
RWA	RWA
	BLM
	SHN
SKN	KNA
LCA	LCA
	MAF
	SPM
VIN	VCT
SAM	WSM
SMR	SMR
STP	STP
KSA	SAU
SCO	[6]
SEN	SEN
SRB	SRB
SEY	SYC
SLE	SLE
SIN	SGP
	SXM
SVK	SVK
SVN	SVN
SOL	SLB
SOM	SOM
RSA	ZAF
	SGS
SSD	SSD
ESP	ESP
SRI	LKA
SDN	SDN
SUR	SUR
	SJM
SWZ	SWZ
SWE	SWE
SUI	CHE
SYR	SYR
TPE	TWN
TJK	TJK
TAN	TZA
THA	THA
TLS	TLS
TOG	TGO
	TKL
TGA	TON
TRI	TTO
TUN	TUN
TUR	TUR
TKM	TKM
TCA	TCA
	TUV
UGA	UGA
UKR	UKR
UAE	ARE
ENG	GBR
USA	USA
	UMI
VIR	VIR
URU	URY
UZB	UZB
VAN	VUT
	VAT
VEN	VEN
VIE	VNM
WAL	WAL
	WLF
	ESH
YEM	YEM
ZAM	ZMB
ZIM	ZWE
